Maplegrove	Black
Coloris	Black
Stoneshire	Black
Argenmomble	Black
Kinibourg	Black
Ragewharf	Black
Tenea	Black
Angeldrift	Black
Barcergos	Black
Dawnpeak	Red
Levannet	Black
Orisca	Red
Steepgulch	Black
Tarbella	Black
Windvein	Black
Ambermond	Red
Couryonne	Black
Elderpond	Black
Navalicia	Black
Pearlwater	Black
